1111111
1111111
1111110
1111111
