1111111
1C000E1
1K00001
1111111
