11111
1P001
10101
100C1
10E01
11111